16 16
xxxxxxxxxxxxxxxx
x..............x
x..............x
x..xxx.........x
x....x.........x
x....x.........x
x....xxxx......x
x..............x
x.......x......x
x..xx...x......x
x.......x......x
x..............x
x...x..........x
x....x.........x
x.....x........x
xxxxxxxxxxxxxxxx